16
S.............#G
..............#.
..............#.
..............#.
..............#.
..............#.
..............#.
..............#.
..............#.
..............#.
..............#.
..............#.
..............#.
..............#.
.##############.
................
