24
......#...#......#.#....
.####.##.##.####.....##.
.#..#........#.#.#####G.
###...###..###...#...#..
#.#.###.##.#.#####.#.###
.........#...#.....#....
.##.###########.##...##.
..#.#.##..##.#...#####..
.##.#...............#...
..#.#.##..####.###..###.
#.#.###..##.S#.#.#..#...
..#.#.....#....#....#.##
.##.#.#####.######....#.
..#.#..#.#...#..#...#.#.
#.#.#....###.##.#.###...
#.#.#.##..#.............
..#.#..#....###..###.###
.##.##.#..#.#.#..#.#..#.
.#...#.#.####.#.##.##.#.
##.#.###................
...#......#..#.#..#.#.##
##...###.###.########.#.
.##.##.#..#....#.#......
..........#..#.....#..##
