64
S.............................................................#G
.##############################################################.
..............................................................#.
.##############################################################.
..............................................................#.
.##############################################################.
..............................................................#.
.##############################################################.
..............................................................#.
.##############################################################.
..............................................................#.
.##############################################################.
..............................................................#.
.##############################################################.
..............................................................#.
.##############################################################.
..............................................................#.
.##############################################################.
..............................................................#.
.##############################################################.
..............................................................#.
.##############################################################.
..............................................................#.
.##############################################################.
..............................................................#.
.##############################################################.
..............................................................#.
.##############################################################.
..............................................................#.
.##############################################################.
..............................................................#.
.##############################################################.
..............................................................#.
.##############################################################.
..............................................................#.
.##############################################################.
..............................................................#.
.##############################################################.
..............................................................#.
.##############################################################.
..............................................................#.
.##############################################################.
..............................................................#.
.##############################################################.
..............................................................#.
.##############################################################.
..............................................................#.
.##############################################################.
..............................................................#.
.##############################################################.
..............................................................#.
.##############################################################.
..............................................................#.
.##############################################################.
..............................................................#.
.##############################################################.
..............................................................#.
.##############################################################.
..............................................................#.
.##############################################################.
..............................................................#.
.##############################################################.
................................................................
................................................................
