16
......#.......#G
##.####.#####.#.
......#.#...#.#.
###.###.###.#...
.#..#...#.#.####
.#.##.###.......
....#...#.#####.
#.###.#.#...#...
......#...#.###.
####.######...#.
.#.#....#.#.###.
.#...#.##...#...
.#####.#..#####.
..........#..S#.
.##.##.##.#.###.
.#...#.#..#.....
