48
...#.......#.......#..#S#....#.......#..........
.#.#.####.##.###.#.#.##.#.##.#.#.###.#.#####.###
.#.#.#..#....#.#.#...#..#..#.#.#...#.#.....#.#..
##.#.##.######.#.#####.#####.#.###.#.#####.#.#..
...#.......#...#.....#.#.....#.#.#.#.#...#.#.##.
.#########.###.#####.#.#.###.#.#.#.#.#.#.#.#.#..
.........#.#.....#.#...#...#.#...#.#.#.#...#.#..
.###.#####.#.###.#.#######.#####.#.#.#.#####.###
...#.......#.#.#...#...#.........#.#.#....G#....
##.#########.#.###.#.#.#.#########.#.###.####.##
...#.#.......#...#.#.#.#.#.........#...#.#..#.#.
.###.#.##..#.#.###.###.#.#.###########.###......
.#......#..#.#.........#.#.#.......#...#.....#..
.###########.###########.#.#.#######.###.#######
...........#.............#.#.....#...#...#......
##########.#.#############.###.#.#.#.###.#.##.#.
.........#.#.............#...#.#...#...#.#.#..#.
.##.##.###.#.#######.#######.#.#######.#.#.#.###
..#..#.#...#.#.....#.#.....#.#.#.....#...#.#....
#.##.#.#.#####.###.#.#.###.#.#.#.#########.#####
#..#.#.#.......#.#.#...#.#...#.#.#.......#.#....
##.#.#.#########.#.#.###.#.#####.#.#####.#.#.###
#..#.#.#...#.......#.#.....#.....#.#.....#.#.#..
#.##.#.###.#.#######.#######.#####.#.###.#.#.##.
..#..#.....#.#.#.............#.....#.#...#.#....
###.####.###.#.#.#####.#######.#####.#####.####.
....#....#.#.#...#...#.#...#...#...........#.#..
.#.####....#.#.###.#.#...#...#.#...#######.#.#.#
.###..######.#.#.#.#.#########.#.###.....#.#.#.#
.........#.#.#...#.#.....#.....#.#.#.###.#.#.#.#
.#######.#.#.#####.#####.#.#####.#.#.#.#...#.#.#
.#.....#...#.#.....#...#.#.#.#.#.#.#.#.#####.#.#
.#####.#.#.#.#.#######.#.#.#.......#.#.........#
.#.....###.#.#.#.....#.#.#.######..#.#.#.####.##
.#.###.#.#.#.#.#.###.#...#......#..#.###...#..#.
.#.#...#.....#.#.#.#.#.#######..#..#.......#..#.
.#.###########.#.#.#.#.......#.##.##########.##.
.#...#...#.....#.#.#.#...#.#.#....#.............
.###.#.#.#.###.#.#.#.#####.##############.####..
...#...#.#...#.....#.....#........#..#..#..#.#..
##.#####.#.#######.####..#.####.#.##.#.###.#...#
...#...#...#.....#.#.....#....#.#..#.......#.###
.###.#.#####.###.###.########.#.####.#.#####....
.#...#.......#.#.....#.#....#.#......#.#...#.##.
.#.#.#########.#######.#.#..#.######.#.###...#..
.#.#....#......#.........#......#....#...#####..
.######.#.####.#.#####.###.####.######.###.#.###
........#.#..#...#..#....#.#......#....#.......#
